NO ./ruta_a_la_textura_norte
                SO ./ruta_a_la_textura_sur
WE ./ruta_a_la_textura_oeste
        EA ./ruta_a_la_textura_este

F 220,100,0
C 225,30,0

        1111111111111111111111111
        1000000000110000000000001
        1111000001110000000000001
        1001000000000000000000001
111111111011000001110000000000001
100000000011000001110111111111111
11110111111111011100000010001
11110111111111011101010010001
11000000110101011100000010001
100000000000000011000000100011111111111111
100000000000000011010100100000000000000101
11000001110101011111011110N011111111111111
1111011111110101 101111010001
11111111 1111111 111111111111