NO ./ruta_a_la_textura_norte
                SO ./ruta_a_la_textura_sur
WE ./ruta_a_la_textura_oeste
        EA ./ruta_a_la_textura_este

F 100,100,100
C 0,0,255

                         111 
        1111111111111111110111111
        1000000000110000000000001
        1111000001110001000000001
        10010000000000000W0000001
111111111011000001110000000000001
100000000011000001110111111111111
11110111111111011100000010001
11110111111111011101010010001
11000000110101011100000010001
100000000000000011000000100011111111111111
100000000000000011010100100000000000000101
110000011101010111110111100011111111111111
1111011111110101 101111010001
11111111 1111111 111111111111