NO ./textures/eloi.xpm

          SO ./textures/zpalfi.xpm
                                WE ./textures/mono.xpm

EA ./textures/aaron.xpm

F 100,100,1
C 0,0,255

                         111 
        1111111111111111110111111                             111
        1000000000110000100000001                             101
        1111000001110001000000001                             101
        100100000000000000000S001                             101
111111111011000001110000000000001                             101
100000000011000001110111110111111                             101
11110111111111011100000010001                                 101
11110111111111011101010010001                                 101
11000000110101000000000010001                            111  101
1000000000000000110000001000111111111111111111111111111111 1111101111111111111111111111111111111111111111111111111111111111111111111
100000000000000011010100100000000000000000000000000000000010 0000000000000000000000000000000000000000000000000000000000000000000001
1100000111010101111101111000111111111111111111111111111111 111111111111111111111111111111111111111111111111111111111111111111111111
1111011111110101 101111010001
11111111 1111111 111111111111